  ###################
  #   #     #       #
# # ### ####### ### #
# #   #         #   #
# ### ##### #########
#       # #   #     #
# ### # # # ##### ###
#   # # #         # #
##### # # ##### # # #
#     # #   # # # # #
# ##### ### # # ### #
# # # #     #       #
### # ### ### ### ###
# # # #   #     #   #
# # # ### # # # # ###
#         # # # # # #
# ### ### # # ##### #
#   #   # # #       #
# ### ### ### ##### #
# #   #   #       #  
###################  
